####### ##############
#     # #            ######
# ### # #  ####           #
# # # ###  #  #  ### #### #
#A  #      #  #### # #    #
### # ######         #  # #
######################### #
                          #
 ################## #######
 #                # #
 #                # #
B#                ###
##        